R 800     600

              NO         ./assets/eagle.xpm
      SO        ./assets/mossy.xpm
                    WE                   ./assets/greystone.xpm

EA ./assets/redbrick.xpm

F  255,170,85
C        85,170,255

S ./assets/barrel.xpm

1111111111111111111111111      111111111111111
1000000000001110000000001      1100201111000011111111111
1111111000000000000001111111   1111000000000000000000001
      100020000011100011111111111000N0022000011111111111
    1111000011100000000000000000000000011111111
   1100000000000000111111111111111111111
    1110111011111111111
    11101 1000000001111                          111
    11001 1021111111                             101
    11111 11111              1                   111
                
                 
                               111111
          111                  100001111
          111                  100000001
                               110011111
                                1011
   111                          101
   121                          111
   111